####################
# #    #       #   #
#   #  ##  ##    ###
# ###        ###   #
# #    #--#      # #
#   ###    # ## ## #
# #   ######  # #  #
# ###     #        #
#      #     #     #
####################