####################
#.#............#...#
#....#...#.###...###
#.####...#...###...#
#.#.#..###.#.#...#.#
#.#.#.#.#..#.##.##.#
#.....#.........#..#
#.###.#.######.....#
#.#...#..#.#...###.#
#.###.#....##......#
#...#.#.##..#.#.####
###.........#.#.#..#
#.#.###.###...#.##.#
#...#...#...#......#
####################